11 12 20 29 1
???????????????
?             ?
?   ?   ?     ?
?   ?   ?     ?
?   ?   ?     ?
? ??????????? ?
?   ?   ?     ?
?   ?   ?     ?
?   ?  X?     ?
?   ?   ?     ?
? ??????????? ?
?   ?   ?   P ?
?   ?   ?     ?
?            E?
???????????????
